FFFFFFFH
FFFFFGFF
HHFFFHHF
FFHFHHFF
FFFFFFFF
HCFFFFKF
FFFFFFFF
SFHFFFFH
