FFFFFFFH
FFFFKGFF
HHFFFHHF
FFHFHHFF
FFFFFFFF
HCFFFFFF
FFFFFFFF
SFHFFFFH
