FFHHFFFFHFHFFG
FFHHFFFFHFFFHF
FFFFFHFFHFFFFF
KFFFHFHFHFFFFF
HFFHFHFFFFHFFF
FFFHHFHFFFFHFF
FFFFFFFFFFFFFF
FFFFHFHFFHFFFF
FFFHFFFHFFCFHF
FFFHFFFFFFFHFF
FFSFFFHFFFFFFH
FHHFFHFFFFHFFH
FFHFFHFFFFFFFF
FFFFFFHFFFFHFF
